11111111111000111111
00000000000000000000
00000000000000000000
00000000000000000000
10000000000000000001
10000000001110000001
10000000000000000001
10000000000000000001
10000000000000000001
10000000000000000001
10110000000000000001
10000000000000000001
10000000000000000001
10000000000000000001
10000001110000000001
10000000000000000001
10000000000000000001
10000000000000000001
10000000000000000001
11111111110001111111